//Hyvin kevyt "kenttä", AI:n testausta varten.
//Sisältö: //-merkillä alkavat rivit sivuutetaan (kommentit), @-merkillä alkava rivi
//kertoo AI-hahmon/hahmojen (käytännössä epäiltyjen) aloitussijainnit. Y-koord. annetaan ensin, sitten väliviiva, ja sitten x-koord.
//Esimerkiksi: @3-3 -> jos halutaan useampi hahmo, sijainnit erotetaan pilkulla, esim. @1-2,2-1
//Merkit X ja . ja N katsotaan kuuluvaksi karttaan (X = seinä, . = tyhjä ruutu, N = NoGo-alue). Erotetaan jokaisella rivillä jokainen ruutu pilkulla
@12-12
.,.,.,.,.,.,.,.,.,.,X,.,.,.,.,X,.,.,.,.,.,.,.,.
.,.,.,.,.,.,.,.,.,.,X,.,.,.,.,X,.,.,.,.,.,.,.,.
.,.,X,X,X,X,.,.,.,.,X,.,.,.,.,X,.,.,.,.,.,.,.,.
.,.,X,.,.,X,.,.,.,.,X,.,.,.,.,X,.,.,.,.,.,.,.,.
.,.,X,X,X,X,.,.,.,.,X,.,.,.,.,X,.,.,.,.,X,X,X,X
.,.,.,.,.,.,.,.,.,.,.,X,X,X,X,X,.,.,.,.,X,.,.,.
.,.,.,.,.,.,.,.,.,.,.,.,.,.,.,.,.,.,.,.,X,.,.,.
X,X,X,X,X,X,.,.,.,.,.,X,X,.,.,.,.,.,.,.,X,.,.,.
.,.,.,.,.,X,.,.,.,.,.,.,.,.,.,.,.,.,.,.,X,X,X,X
.,.,.,.,.,X,.,.,.,.,.,.,.,.,.,.,.,.,.,.,.,.,.,.
.,.,.,.,.,X,.,.,.,.,.,.,.,.,.,.,.,.,.,.,.,.,.,.
X,X,X,X,X,X,.,.,.,.,.,.,.,.,.,.,.,X,X,X,X,X,X,X
.,.,.,.,.,.,.,.,.,.,.,.,.,.,.,.,.,X,.,.,.,.,.,.
.,.,.,.,.,.,.,.,.,.,.,.,.,.,.,.,.,X,.,.,.,.,.,.
.,.,.,.,.,.,.,.,.,.,.,.,.,.,.,.,.,X,.,.,.,.,.,.
.,.,.,.,.,.,.,.,.,.,.,.,.,.,.,.,.,X,.,.,.,.,.,.
.,.,.,.,.,.,.,.,.,.,.,.,.,.,.,.,.,X,.,.,.,.,.,.
.,.,.,.,.,.,.,.,.,.,.,.,.,.,.,.,.,X,.,.,.,.,.,.
.,.,.,.,.,.,.,.,.,.,.,.,.,.,.,.,.,X,.,.,.,.,.,.
.,.,.,.,.,.,.,.,.,.,.,.,.,.,.,.,.,X,.,.,.,.,.,.
.,.,.,.,.,.,.,.,.,.,.,.,.,.,.,.,.,X,.,.,.,.,.,.
.,.,.,.,.,.,.,.,.,.,.,.,.,.,.,.,.,X,.,.,.,.,.,.
.,.,.,.,.,.,.,.,.,.,.,.,.,.,.,.,.,X,.,.,.,.,.,.
.,.,.,.,.,.,.,.,.,.,.,.,.,.,.,.,.,X,.,.,.,.,.,.